thông dịch : vb none man,language,language
sáng : nn time often
sẽ : rb schedule
thường : rb repeat
quen : vb none people,people,reason
cấp hai : nn level student
tiếng : nn language country
hai : cd count animal people
con : unn none animal
khôn : adj smart animal people
dạy : vb none woman,student
anh : nn man name
Anh : nn country
Việt : nn country
học sinh : nn student
của : in none animal,people
vì : cc reason
nó : prp thing
chú rể : nn man
huyền đề : nn kind_animal animal
sủa : vb none animal,time
nữ tính : adj kind_person woman
nuôi : vb none people,animal
họ : prp people
rất : rb
người : nn people
cô dâu : nn woman
là : vb none woman,woman
là : vb none man,man
là : vb none thing,dog
với : cc none talk,woman
chó : nn animal
nói chuyện: vb talk man,woman
qua : cc none language,language
này : det none
một : det none animal
Hùng : nnp name
mỗi : det often time
chị : nn woman name
Hoa : nnp name
